{
  "US": "en",
  "AC": "en",
  "AD": "ca",
  "AE": "ar",
  "AF": "ar",
  "AG": "en",
  "AI": "en",
  "AL": "sq",
  "AM": "hy",
  "AO": "pt",
  "AQ": "en",
  "AR": "es",
  "AS": "sm",
  "AT": "de",
  "AU": "en",
  "AW": "nl",
  "AX": "sv",
  "AZ": "az",
  "BA": "bs",
  "BB": "en",
  "BD": "bn",
  "BE": "nl",
  "BF": "fr",
  "BG": "bg",
  "BH": "ar",
  "BI": "fr",
  "BJ": "fr",
  "BL": "fr",
  "BM": "en",
  "BN": "ms",
  "BO": "es",
  "BQ": "nl",
  "BR": "pt",
  "BS": "en",
  "--BT": "",
  "BV": "no",
  "BW": "en",
  "BY": "be",
  "BZ": "en",
  "CA": "kn",
  "CC": "ms",
  "CD": "fr",
  "CF": "fr",
  "CG": "fr",
  "CH": "de",
  "CI": "fr",
  "CK": "en",
  "CL": "es",
  "CM": "en",
  "CN": "zh",
  "CO": "es",
  "CP": "fr",
  "CR": "es",
  "CU": "es",
  "CV": "pt",
  "CW": "nl",
  "CX": "en",
  "CY": "el",
  "CZ": "cs",
  "DE": "de",
  "DG": "en",
  "DJ": "fr",
  "DK": "da",
  "DM": "en",
  "DO": "es",
  "DZ": "ar",
  "EA": "es",
  "EC": "es",
  "EE": "et",
  "EG": "ar",
  "EH": "ar",
  "ER": "en",
  "ES": "es",
  "ET": "so",
  "EU": "en",
  "FI": "fi",
  "FJ": "en",
  "FK": "en",
  "--FM": "",
  "FO": "da",
  "FR": "fr",
  "GA": "fr",
  "GB": "en",
  "GD": "en",
  "GE": "ka",
  "GF": "fr",
  "GG": "en",
  "GH": "en",
  "GI": "en",
  "--GL": "",
  "GM": "en",
  "GN": "fr",
  "GP": "fr",
  "GQ": "es",
  "GR": "el",
  "GS": "en",
  "GT": "es",
  "GU": "en",
  "GW": "pt",
  "GY": "en",
  "HK": "zh",
  "HM": "en",
  "HN": "es",
  "HR": "hr",
  "HT": "fr",
  "HU": "hu",
  "IC": "es",
  "ID": "id",
  "IE": "ga",
  "IL": "he",
  "IM": "en",
  "IN": "hi",
  "IO": "en",
  "IQ": "ar",
  "IR": "fa",
  "IS": "no",
  "IT": "it",
  "JE": "en",
  "JM": "en",
  "JO": "ar",
  "JP": "ja",
  "KE": "sw",
  "KG": "ky",
  "KH": "km",
  "KI": "en",
  "TR": "fr",
  "--KM": "",
  "KN": "en",
  "KP": "ko",
  "KR": "ko",
  "KW": "ar",
  "KY": "en",
  "KZ": "kk",
  "LA": "lo",
  "LB": "ar",
  "LC": "en",
  "LI": "de",
  "LK": "si",
  "LR": "en",
  "LS": "st",
  "LT": "lt",
  "LU": "lb",
  "LV": "lv",
  "LY": "ar",
  "MA": "es",
  "MC": "fr",
  "MD": "ro",
  "ME": "sr",
  "MF": "nl",
  "MG": "mg",
  "MH": "en",
  "MK": "mk",
  "ML": "fr",
  "--MM": "",
  "MN": "mn",
  "MO": "zh",
  "MP": "en",
  "MQ": "fr",
  "MR": "ar",
  "MS": "en",
  "MT": "it",
  "MU": "en",
  "MV": "en",
  "MW": "en",
  "MX": "es",
  "MY": "ms",
  "MZ": "sw",
  "NA": "en",
  "NC": "fr",
  "NE": "fr",
  "NF": "en",
  "NG": "en",
  "NI": "es",
  "NL": "nl",
  "NO": "no",
  "NP": "ne",
  "NR": "en",
  "NU": "en",
  "NZ": "en",
  "OM": "ar",
  "PA": "es",
  "PE": "es",
  "PF": "fr",
  "PG": "en",
  "PH": "en",
  "PK": "en",
  "PL": "pl",
  "PM": "fr",
  "PN": "en",
  "PR": "es",
  "PS": "he",
  "PT": "pt",
  "PW": "en",
  "PY": "es",
  "QA": "ar",
  "RE": "fr",
  "RO": "ro",
  "RS": "sr",
  "RU": "ru",
  "RW": "en",
  "SA": "ar",
  "SB": "en",
  "SC": "en",
  "SD": "ar",
  "SE": "sw",
  "SG": "ms",
  "SH": "en",
  "SI": "sl",
  "SJ": "no",
  "SK": "sk",
  "SL": "en",
  "SM": "it",
  "SN": "fr",
  "SO": "so",
  "SR": "nl",
  "SS": "ar",
  "ST": "pt",
  "SV": "es",
  "SX": "nl",
  "SY": "ar",
  "SZ": "en",
  "TA": "en",
  "TC": "en",
  "TD": "ar",
  "TF": "fr",
  "TG": "fr",
  "TH": "th",
  "TJ": "ru",
  "TK": "pt",
  "TL": "ru",
  "TM": "ar",
  "TN": "en",
  "TO": "tr",
  "TT": "en",
  "TV": "en",
  "TW": "zh",
  "TZ": "sw",
  "UA": "uk",
  "UG": "sw",
  "UM": "en",
  "UN": "en",
  "UY": "es",
  "UZ": "uz",
  "VA": "it",
  "VC": "en",
  "VE": "es",
  "VG": "en",
  "VI": "en",
  "VN": "vi",
  "VU": "en",
  "WF": "fr",
  "WS": "sm",
  "XX": "sq",
  "YE": "ar",
  "YT": "fr",
  "ZA": "en",
  "ZM": "en",
  "ZW": "en"
}
