{
  "US": "en",
  "AC": "en",
  "AD": "ca",
  "AE": "ar",
  "AF": "ar",
  "AG": "en",
  "AI": "en",
  "AL": "sq",
  "AM": "hy",
  "AO": "pt",
  "AQ": "en",
  "AR": "es",
  "AS": "sm",
  "AT": "de",
  "AU": "en",
  "AW": "nl",
  "AX": "sv",
  "AZ": "az",
  "BA": "bs",
  "BB": "en",
  "BD": "bn",
  "BE": "nl",
  "BF": "fr",
  "BG": "bg",
  "BH": "ar",
  "BI": "fr",
  "BJ": "fr",
  "BL": "fr",
  "BM": "en",
  "BN": "ms",
  "BO": "es",
  "BQ": "nl",
  "BR": "pt",
  "BS": "en",
  "--BT": "",
  "BV": "no",
  "BW": "en",
  "BY": "be",
  "BZ": "en",
  "CA": "kn",
  "CC": "ms",
  "CD": "fr",
  "CF": "fr",
  "CG": "fr",
  "CH": "de",
  "CI": "fr",
  "CK": "en",
  "CL": "es",
  "CM": "en",
  "CN": "zh",
  "CO": "es",
  "CP": "fr",
  "CR": "es",
  "CU": "es",
  "CV": "pt",
  "CW": "nl",
  "CX": "en",
  "CY": "el",
  "CZ": "cs",
  "DE": "de",
  "DG": "en",
  "DJ": "fr",
  "DK": "da",
  "DM": "en",
  "DO": "es",
  "DZ": "ar",
  "EA": "es",
  "EC": "es",
  "EE": "et",
  "EG": "ar",
  "EH": "ar",
  "ER": "en",
  "ES": "es",
  "ET": "so",
  "EU": "en",
  "FI": "fi",
  "FJ": "en",
  "FK": "en",
  "--FM": "",
  "FO": "da",
  "FR": "fr",
  "GA": "fr",
  "GB": "en",
  "GD": "en",
  "GE": "ka",
  "GF": "fr",
  "GG": "en",
  "GH": "en",
  "GI": "en",
  "--GL": "",
  "GM": "en",
  "GN": "fr",
  "GP": "fr",
  "GQ": "es",
  "GR": "el",
  "GS": "en",
  "GT": "es",
  "GU": "en",
  "GW": "pt",
  "GY": "en",
  "HK": "zh",
  "HM": "en",
  "HN": "es",
  "HR": "hr",
  "HT": "fr",
  "HU": "hu",
  "IC": "es",
  "ID": "id",
  "IE": "ga",
  "IL": "he",
  "IM": "en",
  "IN": "hi",
  "IO": "en",
  "IQ": "ar",
  "IR": "fa",
  "IS": "no",
  "IT": "it",
  "JE": "en",
  "JM": "en",
  "JO": "ar",
  "JP": "ja",
  "KE": "sw",
  "KG": "ky",
  "KH": "km",
  "KI": "en",
  "TR": "fr",
  "KM": "",
  "KN": "",
  "KP": "",
  "KR": "",
  "KW": "",
  "KY": "",
  "KZ": "",
  "LA": "",
  "LB": "",
  "LC": "",
  "LI": "",
  "LK": "",
  "LR": "",
  "LS": "",
  "LT": "",
  "LU": "",
  "LV": "",
  "LY": "",
  "MA": "",
  "MC": "",
  "MD": "",
  "ME": "",
  "MF": "",
  "MG": "",
  "MH": "",
  "MK": "",
  "ML": "",
  "MM": "",
  "MN": "",
  "MO": "",
  "MP": "",
  "MQ": "",
  "MR": "",
  "MS": "",
  "MT": "",
  "MU": "",
  "MV": "",
  "MW": "",
  "MX": "",
  "MY": "",
  "MZ": "",
  "NA": "",
  "NC": "",
  "NE": "",
  "NF": "",
  "NG": "",
  "NI": "",
  "NL": "",
  "NO": "",
  "NP": "",
  "NR": "",
  "NU": "",
  "NZ": "",
  "OM": "",
  "PA": "",
  "PE": "",
  "PF": "",
  "PG": "",
  "PH": "",
  "PK": "",
  "PL": "",
  "PM": "",
  "PN": "",
  "PR": "",
  "PS": "",
  "PT": "",
  "PW": "",
  "PY": "",
  "QA": "",
  "RE": "",
  "RO": "",
  "RS": "",
  "RU": "",
  "RW": "",
  "SA": "",
  "SB": "",
  "SC": "",
  "SD": "",
  "SE": "",
  "SG": "",
  "SH": "",
  "SI": "",
  "SJ": "",
  "SK": "",
  "SL": "",
  "SM": "",
  "SN": "",
  "SO": "",
  "SR": "",
  "SS": "",
  "ST": "",
  "SV": "",
  "SX": "",
  "SY": "",
  "SZ": "",
  "TA": "",
  "TC": "",
  "TD": "",
  "TF": "",
  "TG": "",
  "TH": "",
  "TJ": "en",
  "TK": "pt",
  "TL": "ru",
  "TM": "ar",
  "TN": "en",
  "TO": "tr",
  "TT": "en",
  "TV": "en",
  "TW": "zh",
  "TZ": "sw",
  "UA": "uk",
  "UG": "sw",
  "UM": "en",
  "UN": "en",
  "UY": "es",
  "UZ": "uz",
  "VA": "it",
  "VC": "en",
  "VE": "es",
  "VG": "en",
  "VI": "en",
  "VN": "vi",
  "VU": "en",
  "WF": "fr",
  "WS": "sm",
  "XX": "sq",
  "YE": "ar",
  "YT": "fr",
  "ZA": "en",
  "ZM": "en",
  "ZW": "en"
}
